1111111
1E0P001
1110001
1C10001
1111111
