11111
1ECP1
10001
10001
10001
11111
