111111111111111
10001P00000E001
100010101111111
100010100000001
100010111111001
101010100010011
100000100000001
111111111111111
