111111111111111
10001P00000E001
100010101111111
1000101000C0001
100010111111001
101010100010011
1C0000100000001
111111111111111
