111111111111111
10001C00000E001
100010101111111
10C0101000C0001
100010111111001
1010101P0010001
1C00001000000C1
111111111111111
