11111111
1EC000P1
11111111
10000001
10010001
11111111
